#,#,#,#,#,#,#,#,#,#,#,#,#,#,#,#,#,#,#,#
#,.,.,.,.,.,.,.,.,.,.,.,.,.,.,.,.,.,.,#
#,.,.,.,.,.,#,.,.,.,.,.,.,.,.,.,.,.,.,#
#,.,.,.,.,.,#,.,.,.,.,.,.,.,.,.,.,.,.,#
#,.,.,.,.,.,#,.,.,.,.,.,.,.,.,.,.,.,.,#
#,.,.,.,.,.,#,.,.,.,.,.,.,.,.,.,.,.,.,#
#,.,#,#,#,#,#,#,#,#,+,.,#,#,#,#,#,#,.,#
#,.,.,.,.,.,#,.,.,.,.,.,.,.,.,.,.,.,.,#
#,.,.,.,.,.,#,.,.,.,.,.,.,.,.,.,.,.,.,#
#,.,.,.,.,.,#,.,.,.,.,.,.,.,.,.,.,.,.,#
#,.,.,.,.,.,#,.,.,.,.,.,.,.,.,.,.,.,.,#
#,.,.,.,.,.,.,.,.,.,.,.,.,.,.,.,.,.,G,#
#,#,#,#,#,#,#,#,#,#,#,#,#,#,#,#,#,#,#,#
