#,#,#,#,#,#,#,#,#,#,#,#,#,#,#,#,#,#,#,#
#,S,.,.,.,.,.,.,.,.,.,.,.,.,.,.,.,.,.,#
#,.,.,.,.,.,#,.,.,.,.,.,.,.,.,.,.,.,.,#
#,.,.,.,.,.,#,.,.,.,.,.,.,.,.,.,.,.,.,#
#,.,.,.,.,.,#,.,.,.,.,.,.,.,.,.,.,.,.,#
#,.,.,.,.,.,#,.,.,.,.,.,.,.,.,.,.,.,.,#
#,.,#,#,#,#,#,#,#,#,+,.,#,#,#,#,#,#,.,#
#,.,.,.,.,.,#,.,.,.,.,.,.,.,.,.,.,.,.,#
#,.,.,.,.,.,#,.,.,.,.,.,.,.,.,.,.,.,.,#
#,.,.,.,.,.,#,.,.,.,.,.,.,.,.,.,.,.,.,#
#,.,.,.,.,.,#,.,.,.,.,.,.,.,.,.,.,.,.,#
#,.,.,.,.,.,.,.,.,.,.,.,.,.,.,.,.,.,.,#
#,#,#,#,#,#,#,#,#,#,#,#,#,#,#,#,#,#,#,#
