#,#,#,#,#,#,#,#,#,#,#,#,#
#,^,A,A,#,A,#,A,+,A,A,A,#
#,A,A,A,#,+,#,A,A,A,A,A,#
#,A,A,+,#,A,A,A,A,A,A,#,#
#,A,A,A,#,A,A,+,A,A,A,A,#
#,#,A,A,#,A,A,A,A,+,A,+,#
#,#,#,A,A,A,A,A,A,A,A,A,#
#,A,A,A,A,A,A,A,#,#,#,#,#
#,#,#,#,A,A,A,A,A,A,A,A,#
#,A,#,A,A,A,A,A,A,A,+,A,#
#,A,#,A,A,A,A,A,A,A,#,A,#
#,A,A,A,A,A,A,A,A,#,#,A,#
#,A,#,#,A,A,A,#,A,#,#,#,#
#,#,A,A,A,A,A,#,A,A,A,A,#
#,A,A,A,A,A,A,#,A,A,A,A,#
#,A,_,A,A,#,A,#,A,A,A,_,#
#,A,A,A,A,A,A,#,A,A,A,A,#
#,A,+,A,#,A,#,#,A,#,A,A,#
#,A,A,A,#,A,#,#,#,#,A,A,#
#,#,#,#,#,#,#,#,#,#,#,#,#
